100
2112112122122212222111121212121122111221211212222111211222111111121112111122111212122111222112121111
1222212212111121221212121122112112121121112112221112212111221221122221222122121111111112121111112212
1112212211111111222122221222212221121211111221122122211121111222121111122212122212111221212221121221
2221221111111111211212112211111112221211221211121222122112112112212222211221211121222112111221211211
1221121221121212111221122122211121112122221212122211121221122222111211211112211121121112122211122222
1111122122211221222212221222221112221121111221222121211112121121212222121212211221112112112212222122
1112111122112222121111111111212211211211221122122112111112221122221122212122212112121122122111211211
2111221211122111212211211221112121112111111112112121112222222111122222222122112111222222111211122212
1212212121212221222111221122222111121112211122221221222211211221212221122121111222211112122112111211
1212121112112211122222212111221112122122212121112112112111211111221122121122112211111121122222212222
2121111222121221111122212122122121211222122112222111222212211212121122121111211121222221122112121211
2112122221121112221221121121221121212121211121222112211211111212221122121112121222122221122122121112
2211111122212122212122111211121211111211111212121212221222212111112222222222112111211221212221111222
1121212121112111122111111211221111121221112222212112121222122211221212122112122111121221111212111122
1212111221122211121121222221111112112222111222111222112111212121111222222222111112121112211211211221
1122112211211111212222221212112211222222212111212211121112112212212121222212222222221121212121112121
1122211112112112221122211221212112112222111121122111212122122111121122112211222222212221112121111122
2122111121212221112221121221122212122222221221111222122112111112111221211111111222112222221222222222
1222211112122111221112222212212212122211121111221211112111211211222212122222211112122211212222112222
2121122111121112122222111112211221222222212111121121121211112221121211112121121221212121221221212122
2122111212121211222111212212212212121222121112111121122212211111122122212221111212211111112211122111
2212221112122221111121211222222122111212112221221122112211122111211222211222211211121121121222112211
1111121122111121212122212221121221211112212111122122222221211212122121222211221111222121212222211111
2211212111222212122112222121221211211111122222122121122112112122221222222111112111212222212111211122
2212111111122221111111211121212111112212112211122212211111221112212122121111221211212211112121111222
1211112121212112122211212212212222221212121212121112221111122222212222121121222121122111121111222212
2122111222212222122211111122221211221221221122211112121212212121222212221221222221211121221121111121
1212122122221212112221122221222112111211122222212211122122111122122121111122111222211112121121222221
2112211211221112122222211111122122122212212211222212222111221121111212212122211121211222112121112212
2112111212211111221221121211212112211212211222121111222221121222211212112211122222112112222221122222
1112121221212121222111111112121121212121122111211122122212221121212221212121112111122111221121222112
2122222211122211212222222212111111122221112222222211122122122121111111221221122222221211221221122212
1112121122222122121122121222212112111122122222111222121122122222112211222221111111211111212111121211
2112121112112122212212221222211221211111221122222222211122122111112221211111112212112211122212222221
2211211112222222221222222212121122111221212112122212121121212112122122221212222212122112112111111212
1212212222122212112112221222221212111121122122121222211122212121222222121111211122221212222221122111
2222211212222221111121111211212212122221111122212122222112121211122121222211222222212122211112121221
2221122122112221211212122122121121222111221221112221211222211212122111211121222121221211212111121111
2221111221221211221112121111211212112121121111222222121122112211121221111222222212212122211212222222
1222212111211212112112122212222121112111211112212221211212222121111212221212111112121222221121222221
2222221212221112212221222221222211112122111222211111121122221121221212221221221122211121221111112111
1122122111212212212112111222121212122111121112222121122221221212222211111121121121122212222111212221
1111121212122211122121211121111221121112122121112112111112121211111211211222111211211222111212212111
2121112211222112122112212111211122221111212111222112111222211222112112112121122212222121112112222222
2112111221222111221222222112122112222221211112121212122221212211112212122112222121212111211212122212
2221211112211121112221212122111221112111221122121121211112211121112221212112111121212211111122112222
2222121212122221122112211222221111121111211121121122221112122111121112112111112221112111222121212121
1122122212111212212222122121111212221222222111112112221121212222122211112112221111112212212212121112
1211212121121111212212122122212221221112112221121121121121221211221111112122211112212121111112212221
2121211212122122112111112212111111211122221122122211211211222121212111221111111211212212222212221221
1212222222122211221211122212212111211122112211212112111211122222112112112111111221122211221212211112
2121222122121112221111111212212222111212222111221212121212112222222112222122211112122212222112222111
2211211121111211211121122222211222222112112111212121112212112222222121122211212122221212222121212212
2112122222112112122212221211211212222221222122222212222211122111122122111122111222121111211112112112
1112211211221222111212121112111112221111221221211221121122112121222111212222112122122121112211112221
1111112122222222212222212122222222112111122222111112111211122221121112111122222121212121112112221122
1111212211122121122122211111212121112112111222111212221212112122111112112222121122122112212221211111
1121222211212222221212122112121212121122111222122122122121121222122222211211221222222112212212212111
1122212122222111112122221211222122212221212212111212121211211111122211222121121222211221121112121211
1122122121221222221122212121221122221122112112221122211212222221122122212112121122121121222222122122
1112112121121212222211211121111112112112211121221211212212122111212212221211212221122221222221212121
1111122112221212112222211111121122111222122212221211221212222222222212122121221221121111111122122221
2211222122122122112211212212222212212121111122112121112112222111221222111111222111221211121222121122
2212112211122122121212122221211211211112112111211221111211211122111122122212211121222111122221222222
2122211122111222221122122211111221121121122111221112121211111221121121221121211112112122111221112221
1122111111122112121212121122111222211121111112212121111211212112122111122221212212121112212112112222
1112111111111221111211112121222112211221122121211212111111212111121121122212211121221212112212112111
2121222122112211112221111221111122111212221211111222221211121221222112122211212111222212112221222221
1222221112111111222122121212121212212212222212122222222221111212112211121121222221112212211112121111
1111211121111221121211222212221122212112112112112222122111122121122211212112212211212112211212212111
1121121221222221212112222122122212212121121111222211212112112111122212222211222221221211211112211121
2211112211222112111211211212112221121221112221212221221121121111221222221112112121122222212121111111
2221211112122121121122212122111112222121221122121222222111121112111122121211221112222221212112211111
2222121121211212222112111222112211112211222212112222222121111121112222122122112111221212212112121111
1211121211211121122112111121211221222212222222112122122121121121212221222121122122222211222122221212
1122121122211211122112211222122222222112121111112222211221221212121112112221121121111112112212211211
2121121112111112222122211211222211121212122122111122222211122211222221222122222111211211212111221211
2111221122122122111222221111122122121112221221221222121112221212211112211211222211112112121122212212
2212221212121121121111112222211111222221121212112111122222212212211221121222212112122122111111121222
1112211122222222222211121111122211222222111112211222121222222211211212112211111221222111111122111221
1122112212111122121122111212212221122122222222121121122111221111121112212112121122212212111122122221
2221222122211111112212121221112211212221222221221222121211222221121112121212221221112212212212222111
1222112212212112222222211221222221221212121121221221212112212221212222122222212222112212212221121112
2221221122222222211121122121211111112212212211112112211122121111111222212121212212212121122221221112
2121122121211212221211221122221111221112111121211121221212212112122221122221221111121212221212112121
1121212111222221222121212212222122222122221112111221211212121111111112211212111221221122222122112222
1222222221221121111221211121111211212222222221222122121221222111212212211122211222121222121222212211
1221212111122212221212212222211111222122112111212222221121121222222211221121112221122212111221122121
1221121222222111222121111111221112111222112221212222211222211211121211112222212222112111122111221222
2122112111122111221121111121111121212121111121121222112122121212111222112112121221221122112222122112
1211121111111112211222211122222111212212221112122111111111121121111111221111112222112221222112221221
2221222122122211112112212122111211111111111221112111212112211122222221122121212122121211121211112122
1222221121221112121122121112221212112211112112112211222222111212222111211112121122212222122211222221
1122212212222122211112211111221111211112112211222121222211111221222122221112111122111222212212212121
1212121221211221222122222121222122222222222112212211112121221211122211112111221111121122222221111111
1121112112111121222111212122221121121222112222221222222211112212112222112122221121222121211221222122
1122222122211111121221212121121221211221221221112111112122121212121221212222212221222112221121112112
2211212111121212222221122112211211111111122222212221122211111112122212111212221111111121111211121122
2211112212211211221111112221121111211121122111111222112122211221122212111211221121112121221211122122
1112121121121122221122122222221122221111221222212221212221221211212121221221121212121212121121121122