2112112122122212222111121212121122111221211212222111211222111111121112111122111212122111222112121111
12222122121111X1221X1212112211211212112111X11222111221X11122122112222122212212111111111X121111112212
11122122111111112221222212222122211212111112211221222111X111122212111112221212221X111221X122211X1221
222122111111111121121211221111111222121122121112122212211X112112212222211221211121222112111221X11211
12211212211X121X1112211221222111X111X12222121X122211121221122222111211211112211121121112122211122222
11111221222112212222122212222211122211211112212221X1X111121211212122221X1X1221122111X112112212222122
111X111122112222121111111111212211211X1122112212211X11111222112222112221212221211X121122122111211211
2111221X111221112122112112211121X111X111111112112121112222222111122222222122112111222222111X11122212
121221X1X1X12221222111221122222111121112211122221221222211211221212221122121111222211112122112111211
12121X111211221112222221211122111X12212221212111211X112111211111221122121122112211111121122222212222
21X1111222121221111122212122122121211222122112222111222212211212121122121111X11121222221122112121211
211X1222211211122212211X112122112121X121X111X12221122112111112122211221211121X1222122221122122121112
2211111122212122212122111211121X11111211111212121X12221222212111112222222222112111X11221X12221111222
11X1X1X1211121111221111112112211111X122111222221X11212122212221122121212211212211112122111121X111122
1X1211122112221112112122222111111X11222211122211122211X111X121X1111222222222111112121112211211X11221
1122112211X1111121222222121X11221122222221X111X122111X111211221221X12122221222222222112121212111X121
112221111X112112221122211221X12112112222111121122111X121221221111X1122112211222222212221112121111122
21221111X1X1222111222112122112221212222222122111122212211211111X111221X11111111222112222221222222222
122221111X122111221112222212212212122211121111221211112111X1121122221X122222211112122211212222112222
212112211112111X12222211111221122122222221X1111211211212111122211212111121211X12212121X1221221X12122
2122111X121212112221112122122122121212221X111X111121122212211111122122212221111212211111112211122111
2212221112122221111121211222222122111212112221221122112211122111X112222112222112111211211X1222112211
1111121122111121X12122212221121221211112212111122122222221X11X12122121222211221111222121212222211111
2211X1X11122221X12211222212122121121111112222212212112211X11X12222122222211111X111212222212111211122
221X111111122221111111211121212111112212112211122212211111221112212122121111221X112122111121X1111222
121111X121212112122211212212212222221212121212121112221111122222212222121121222121122111121111222212
2122111222212222122211111122221211221221221122211112121X122121212222122212212222212111X1221121111121
1X121221222212121122211222212221121112111222222122111221221111221221X1111122111222211112121121222221
2112211211221112122222211111122122122212212211222212222111221121111212212122211121211222112121112212
21121112122111112212211X1X11X12112211212211222121111222221121222211212112211122222112112222221122222
11121212212121X12221111111121X11X1212121122111211122122212221121212221212121112111122111221121222112
2122222211122211212222222212111111122221112222222211122122122121111111221221122222221X11221221122212
11121211222221221X112212122221X11X111122122222111222121122122222112211222221111111211111212111121211
2112121112112122212212221222211221X11111221122222222211122122111112221211111112212112211122212222221
22112111122222222212222222121211221112212121121222121X112121211X122122221X12222212122112112111111212
121221222212221211X1122212222212121111211221221212222111222121X1222222121111211122221X12222221122111
22222112122222211111X11112112122121222211111222121222221121X121112212122221122222221X12221111X121221
2221122122112221211X121221221X11X122211122122111222121122221121X122111211121222121221X1121X111121111
2221111221221211221112121111211X1X1121X11211112222221X112211221112122111122222221221X122211X12222222
122221X1112112121121121222122221X1112111X11112212221X11X122221211112122212121111121X12222211X1222221
2222221X12221112212221222221222211112122111222211111121122221121221212221221221122211121221111112111
112212211121221221211X11122212121X1221111211122221X1122221221212222211111121121121122212222111212221
111112121X1222111221X121112111122112111X1221X1112112111112121211111211X11222111211211222111X12212111
21X111221122211X122112212111X1112222111121211122211211122221122211211211212112221222212111X112222222
211X111221222111221222222112122112222221211112121X12122221212211112212122112222121212111X11X12122212
2221X111122111211122212121221112211121112211221211212111122111X1112221X12112111121212211111122112222
222212121212222112211221122222111112111121112112112222111212211112111X112111112221112111222121X12121
112212221211121221222212212111121222122222211111X1122211212122221222111121122211111122122122121X1112
1X112121X11211112122121221222122212211121122211211X11211212212112211111121222111122121X1111112212221
21X1211212122122112111112212111111211122221122122211X11211222121212111221111111211212212222212221221
1X12222222122211221X11122212212111211122112211212112111211122222112112112111111221122211221212211112
21X1222122121112221111111212212222111X12222111221X121X1212112222222112222122211112122212222112222111
2211211121111X112111X11222222112222221121121112121X111221211222222212112221121X1222212122221X1212212
211212222211X11212221222121121121222222122212222221222221112211112212211112211122212111121111X112112
1112211211221222111212121112111112221111221221211221121122112121222111X12222112122122121112211112221
111111212222222221222221X122222222112111122222111112111211122221121112111122222121X12121112112221122
1111212211122121122122211111212121112112111222111X1222121X112122111112112222121122122112212221211111
1121222211212222221X1212211X121X121X11221112221221221221X11X122212222221121122122222211221221221X111
112221212222211111X122221X11222122212221X12212111X121212112111111222112221X1121222211221121112121X11
112212212122122222112221X12122112222112211211222112221121222222112212221211X121122121121222222122122
111211212112121222221121112111111211X1122111X1221211212212122111212212221X11212221122221222221X12121
11111221122212121122222111111211221112221222122212112212122222222222121221X1221221121111111122122221
221122212212212211221121221222221221X12111112211X12111X112222111221222111111222111221X11121222121122
221211221112212212121212222121121121111X1121112112211112112111221111221222122111X1222111122221222222
21222111221112222211221222111112211X112112211122111X1X1211111221121121221121211112112122111221112221
112211111112211212121212112211122221112111111221X1X111121121211X122111122221212212121112212112112222
111211111111122111121111X1212221122112211221X12112121111112121111211X11222122111X1221212112212112111
21212221221122111122211112211111221112122212111112222212111X122122211X122211212111222212112221222221
1222221112111111222122121212121X1221221222221212222222222111121X1122111211X1222221112212211112121111
1111211121111221121X112222122211222121121121121122221221111221X1122211212112212211212112211X1221X111
11X11X1221222221X1X1122221221222122121211X111122221121211X1121111222122222112222212212112111122111X1
221111221122211X111X11211X121122211212211122212122212211X112111122122222111X1121211222222121X1111111
2221X1111X1221X112112221X1221111122221212211221X122222211112111X111122121X11221112222221212112211111
22221211X1211X12222112111222112211112211222212112222222121111121112222122122112111221212212112121111
1211121X112111X1122112111121X11221222212222222112122122121121121X12221222121122122222211222122221212
1122121122211X1112211221122212222222211212111111222221122122121X12111X11222112112111111X112212211211
2121121112111112222122211211222211121X12122122111122222211122211222221222122222111X11X11X12111221211
21112211221221221112222211111221221211122212212212221211122212122111122112112222111121121X1122212212
2212221X1212112112111111222221111122222112121211X1111222222122122112211X122221211X1221221111111X1222
11122111222222222222111X1111122211222222111112211222121222222211211212112211111221222111111122111221
1122112212111122121122111212212221122122222222121121122111221111121112212112121122212212111122122221
22212221222111111122121X1221112211212221222221221222121X11222221121112121212221221112212212212222111
122211221221211222222221122122222122121212112122122121X112212221X12222122222212222112212212221121112
222122112222222221112112212121111111221221221111X1122111221X11111112222121212122122121X1122221221112
2121122121211212221X112211222211112211121111X1X1112122121221X11X122221122221221111121X12221212112121
112121211122222122212121221222212222212222111X111221211212121111111112211212111221221122222122112222
1222222221221121111221211121111X11212222222221222122121221222111212212211122211222121222121222212211
1221212111122212221212212222211111222122112111212222221121121222222211221121112221122212111221122121
12211X122222211122212111111122111X111222112221212222211222211211121211112222212222112111122111221222
212211X1111221112211211111211111X121212111112112122211X12212121X1112221121121X1221221122112222122112
121112111111111221122221112222211121221222111X122111111111121121111111221111112222112221222112221221
222122212212221111X11221X1221112111111111112211121112121122111222222211221X1X121221X1211121211112122
12222211212211121X11221X111222121X11221111211X1122112222221112122221112111121X1122212222122211222221
11222122122221222111122111112211112111121122112221X1222211111221222122221112111122111222212212212121
1X121X12212112212221222221212221222222222221122122111121X1221211122211112111221111121122222221111111
1121112112111121222111212122221121121222112222221222222211112212112222112122221121222121211221222122
1122222122211111121221212121121221X112212212211121111121221X1212121221X12222212221222112221121112112
22112121111X1212222221122112211211111111122222212221122211111112122212111212221111111121111211121122
22111122122112112211111122211211112111X11221111112221121222112211222121112112211X111X121221211122122
1112121121121122221122122222221122221111221222212221212221221211212121221221121212121212121121121122